XXXXXXXXXXXXXXXXXXXXX
XOOOOOOOOOOOOOOOOOOOX
XOXOXOXOXOXOXOXOXOXOX
XOOOOOOOOOOOOOOOOOOOX
XOXOXOXOXOXOXOXOXOXOX
XOOOOOOOOOOOOOOOOOOOX
XXXXXXXXXXXXXXXXXXXXX