XXXXXXXXXXXXXXXXXXXXX
XOOOOOOOOOOOOOOOOOOOX
XOxOxOxOxOxOxOxOxOxOX
XOOOOOOOOOOOOOOOOOOOX
XOxOxOxOxOxOxOxOxOxOX
XOOOOOOOOOOOOOOOOOOOX
XXXXXXXXXXXXXXXXXXXXX