XXXXXXXXXXXXX
X           X
X x x x x x X
X           X
X x x x x x X
X           X
XXXXXXXXXXXXX